####################
#     #      $     #
#  @  #   ##       #
#     #      ##    #
#   ######         #
#         #   E    #
####################
